111111111111111111111111
100000000000000000000001
100044004400004444400001
100044004400000000440001
100044004400000000440001
100044444400000444400001
100004444400004400000001
100000004400004400000001
100000004400004444440001
100000000000000000000001
100066666600006666660001
100660000660066000066001
100660000660066000000001
100660000660066000000001
100066666600066000000001
100000000000000000000001
100000006606600000000001
100000006600000000000001
100666666606600666666001
106600006606606600006601
106600006606606666666601
106600006606606600000001
106666666006600666666601
100000000000000000000001
111111111111111111111111
