3333333333333333333333333333333333333333333333
3040003300000000030003033000030300003333303433
3000300003333303330300000033000003303330000003
3330333033033303030333303333303033333030333033
3300030033000300000003003330300030000000333003
3303033000030333333033033000003330330330033033
3303003333030000033003003030333300033333330033
3003300000033333033303300030000333033000330333
3033003303000000000303333330330000000030330003
3033033003333333330300000000333303330330000333
3003000033330000030333303033330300333333033333
3303333330000333030000003000000333333300003333
3300003000333300033333033303330000333330333033
3333300030303003000003X00000330330000300000033
3330333330003033303303303033330333303333303003
3300030000333003303333303000333330000330003033
3003000333333033000330003330003030333333033033
3303333333000003303333033330333000000333030003
3300000000033303003300033000333033333300033333
3333033303330000033303003033300000003303330033
3330030003333033333003333000330330300300000333
3330333033030000033033330030330000330333303403
3400003000000333000000033330033033300003000003
3333333333333333333333333333333333333333333333
