111111111111111111111111111111111111111111111111111111111111111111111111111111111111111111111111111111111111111111111111111111
100000000000000000000000000000000000000000000000000000000000000000000000000000000000000000000000000200000000000000000000000001
100000000000000000000000000000000000000000000000000000000000000000000000000000000000000000000000000020000000000000000000000001
100000000000000000000000000000000000000000000000000000000000000000000000000000000000000000000000000000200000000000000000000001
100000000000000000000000000000000000000000000000000000000000000000000000000000000000000000000000000000200000000000000000000001
100000000000000000000000000000000000000000000000000000000000000000000000000000000000000000000000000000020000000000000000000001
100000000000000000000000000000000000000000000000000000000000000000000000000000000000000000000000000000002000000000000000000001
100000000000000000000000000000000000000000000000000000000000000000000000000000000000000000000000000000000200000000000000000001
100000000000000000000000000000000000000000000000000000000000000000000000000000000000000000000000000000000020000000000000000001
100000000000000000000000000000000000000000000000000000000000000000000000000000000000000000000000000000000002000000000000000001
100000000000000000000000000000000000000000000000000000000000000000000000000000000000000000000000000000000000200000000000000001
100000000000000000000000000000000000000000000000000000000000000000000000000000000000000000000000000000000000020000000000000001
100000000000000000000000000000000000000000000000000000000000000000000000000000000000000000000000000000000000002000000000000001
100000000000000000000000000000000000000000000000000000000000000000000000000000005555555555555555555555555555555200000000000001
100000000000000000000000000000000000000000000000000000000000000000000000000000000000000000000000000000000000000020000000000001
100000000000000000000000000000000000000000000000000000000000000000000000000000000000000000000000000000000005000002000000000001
100000000000000000000000000000000000000000033333333333333333300000000000000000000000000000000000000000000005000000200000000001
100000000000000000000000000000000000000000000000000000000000000000000000000000000000000000000000000000000005000000020000000001
100000000000000000000000000000000000000000000000000000000000000000000000000000000000000000000000000000000005000000002000000001
100000000000000000000000000000000000000000000000000000000000000000000000000000000000000000000000000000000005000000000200000001
100000000000000000000000000000000000000000000000000000000000000000000000000000000000000000000000000000000005002222222220000001
10000000000000000000000000000000000000000000000000000000000777777777777777777777777777777777700000000000000500000000000000x001
100000000000000000000000000000000000000000060000000000000000000000000000000000000000000000000000000000000005002222222220000001
100000000000000000000000000000000000000000060000000000000000000000000000000000000000000000000000000000000005000000000200000001
100000000000000000000000000000000000000000060000000000000000000000000000000000000000000000000000000000000005000000002000000001
100000000000000000000000000000000000000000060000000000000000000000000000000000000000000000000000000000000005000000020000000001
100000000000000000000000000000000000000000060000000000000002000000000000000000000000000000000000000000000005000000200000000001
100000000000000000000000000000000000000000060000000000000002000000000000000000000000000000000000000000000000000002000000000001
100000000000000000000000000000000000000000060000000000000002000000000000000000005555555555555555555555555555555520000000000001
100000000000000000000000000000000000000000060000000000000002000000000000000000000000000000000000000000000000000200000000000001
100000000000000000000000000000000000000000060000000000000002000000000000000000000000000000000000000000000000002000000000000001
100000000000000000000000000000000000000000060000000000000002000000000000000000000000000000000000000000000000020000000000000001
100000000000000000000000000000000000000000060000000000000002000000000000000000000000000000000000000000000000200000000000000001
100000000000000000000000000000000000000000000000000000000002000000000000000000000000000000000000000000000002000000000000000001
100000000000000000000000000000000000000000000000000000000002000000000000000000000000000000000000000000000020000000000000000001
100000000000000000000000000000000000000000000000000000000002333333333333333333333333333333333333333333333200000000000000000001
100000000000000000000000000000000000000000000000000000000002000000000000000002000000000000000000000000002000000000000000000001
100000000000000000000000000000000000000000000000000000000002033333333333333302000000000000000000000000020000000000000000000001
100000000000000000000000000000000000000000000000000000000002000000000000000002000000000000000000000000200000000000000000000001
100000000000000000000000000000000000000000000000000000000002333333333333020002000000000000000000000000200000000000000000000001
100000000000000000000000000000000000000000000000000000000001000100010001020002000000000000000000000020000000000000000000000001
100000000000000000000000000000000000000000000000000000000100010001000100020000000000000000000000000200000000000000000000000001
111111111111111111111111111111111111111111111111111111111111111111111111111111111111111111111111111111111111111111111111111111
