111111111111111111111111111111111111111111111111111111111111111111111111111111111111111111111111111111111111111111111111111111
100000000000000000000000000000000000000000005000000000000000000000000000000000000000000000000000000200000000000000000000000001
105555555555555555555555555555555555555555505000000444440004444400000000004444004444000000000000000020000000000000000000000001
105000000000000000000000000000000000000000005000005544400055444000000000055444055444000000000000000000200000000000000000000001
105055555555555555555505555555555555555555555000000544400005444000444444005444005444000444444000000000200000000000000000000001
105050000000000000000000000000000000000000005000000544444444444004445544405444005444004445544400000000020000000000000000000001
105050555555555555555555555555555555555555005000000544455555444054444444005444005444054440544400000000002000000000000000000001
105050500000000000005000500000000000000005005000000544400005444054445550005444005444054440544400000000000200000000000000000001
105050505555555555500050000000000000000005005000000444440004444455444444004444404444455444444000000000000020000000000000000001
105050505000000000555555555555000000000005005000005555500055555005555550055555055555005555550000000000000002000000000000000001
105050505000000000000000000000000000000005005000007000000000000000000000000000000000000000000000000000000000200000000000000001
105050505555555555555555555555555555555555005000007000000000000000000000000000000000000000000000000000000000020000000000000001
105050500000000000000000000000000000000000005000007000000000000000000000000000000000000000000000000000000000002000000000000001
105050555555555555555555555555555555555555005000007000000000000000700000000000005555555555555555555555555555555200000000000001
105050000000000000000000000000000000000000005000007777777777777777700000000000000000000000000000000000000000000020000000000001
105055555555555555555555555555555555555555555000000000000000000000700000000000000000000000000000000000000005000002000000000001
105000000000000000000000000000000000000000033333333333333333300000700000000000000000000000000000000000000005000000200000000001
105000000000000000000000000000000000000000000000000000000000000000700000000000000000000000000000000000000005000000020000000001
105000000000000000000000000000000000000000000000000000000000000000700000000000000000000000000000000000000005000000002000000001
105000000000000000000000000000000000000000000000000000000077777777700000000000000000000000000000000000000005000000000200000001
105000000000000000000000000000000000000000000000000000000070000000000000000000000000000000000000000000000005002222222220000001
10000000000000000000000000000000000000000000000000000000007777777777777777777777777777777777700000000000000500000000000000x001
105000000000000000000000000000000000000000060000000000000070000000000000000000000000000000000000000000000005002222222220000001
105000000000000000000000000000000000000000060000000000000070000000000000000000000000000000000000000000000005000000000200000001
105000000000000000000000000000000000000000060000000000000000000000000000000000000000000000000000000000000005000000002000000001
105000000000000000000000000000000000000000060000000000000000000000000000000000000000000000000000000000000005000000020000000001
105000000000000000000000000000000000000000060000333333333332000000000000000000000000000000000000000000000005000000200000000001
105000000000000000000000000000000000000000060000300030000002000000000000000000000000000000000000000000000000000002000000000001
105000000000000000000000000000000000000000060000303030009002000000000000000000005555555555555555555555555555555520000000000001
105000000000000000000000000000000000000000060000303330000002000000000000000000000000000000000000000000000000000200000000000001
105000000000000000000000000000000000000000060000303000033332000000000000000000000000000000000000000000000000002000000000000001
105000000000000000000000000000000000000000060000303000000002000000000000000000000000000000000000000000000000020000000000000001
105000000000000000000000000000000000000000060000303333333002000000000000000000000000000000000000000000000000200000000000000001
105000000000000000000000000000000000000000000000500000000032000000000000000000000000000000000000000000000002000000000000000001
105000000000000000000000000000000000000000000000333333330002000000000000000000000000000000000000000000000020000000000000000001
105000000000000000000000000000000000000000000000000000030332333333333333333333333333333333333333333333333200000000000000000001
105000000000000000000000000000000000000000000000000000030002000000000000000002000000000000000000000000002000000000000000000001
105000000000000000000000000000000000000000000000000000033302033333333333333302000000000000000000000000020000000000000000000001
105000000000000000000000000000000000000000000000000000030302000000000000000002000000000000000000000000200000000000000000000001
105000000000000000000000000000000000000000000000000000030302333333333333020002000000000000000000000000200000000000000000000001
105555555555555555555555555555555555555555555500000000030001000100010001020002000000000000000000000020000000000000000000000001
100000000000000000000000000000000000000000000000000000030100010001000100020000000000000000000000000200000000000000000000000001
111111111111111111111111111111111111111111111111111111111111111111111111111111111111111111111111111111111111111111111111111111
