111111111111111111111111
100000000000000000000001
100000000000000000000001
100000000000000000000001
100000222220000101010001
100000200020000000000001
10000020x020000100010001
100000200020000000000001
900000220220000101010001
800000000000000000000001
700000000000000000000001
600000000000000000000001
500000000000000000000001
4000000x0000000000000001
300000000000000000000001
200000000000000000000001
111111111000000000000001
110100001000000000000001
110000101000000000000001
110100001000000000000001
110111111000000000000001
110000000000000000000001
111111111000000000000001
111111111111111111111111
