22222222222222222222222222222222222222222277777777777777777777777777777777777777777777777777777777777777777777777777777777
20000000000000000000000000000000000000000200000000000000000000000000000000000000000000000000000000000000000000000000000007
20000000000000000000000000000000000000000200000000007777777777777777777777077777777777777777777770777777777777777777777707
20000000000000000000000000000000000000000200000000007000000000000000000000070000000000000000000000700000000000000000000007
20000000000000000000000000000000000000000200000000007000777777777777777777770007777777777777777777700077777777777777777777
20000000000000000000000000000000000000000200000000007000000000000000000000070000000000000000000000700000000000000000000007
20000000000000000000000000000000000000000200000000007777777777777777777700077777777777777777777000777777777777777777770007
20000000000000000000000000000000000000000200000000007000000000000000000000070000000000000000000000700000000000000000000007
20000000000000000000000000000000000000000200000000007000777777770777777777770007777777077777777777700077777770777777777777
20000000000000000000000000000000000000000200000000007000000000000000000000070000000000000000000000700000000000000000000007
20000000000000000000000000000000000000000200000000007777777777770777777700077777777777077777777000777777777770777777770007
20000000000000000000000000000000000000000200000000007000000000000000000000070000000000000000000000700000000000000000000007
20000000000000000000000000000000000000000200000000007000777777770777777777770007777777077777777777700077777770777777777777
20000000000000000000000000000000000000000200000000007000000000000000000000070000000000000000000000700000000000000000000007
20000000000000000000000000000000000000000200000000007777777777770777777700077777777777077777777000777777777770777777770007
20000000000000000000000000000000000000000200000000007000000000000000000000070000000000000000000000700000000000000000000007
20000000000000000000000000000000000000000200000000007000777777770777777777770007777777077777777777700077777770777777777777
20000000000000000000000000000000000000000200000000007000000000000000000000070000000000000000000000700000000000000000000007
20000000000000000000000000000000000000000200000000007777777777770777777700077777777777077777777000777777777770777777770007
20000000000000000000000000000000000000000200000000007000000000000000000000070000000000000000000000700000000000000000000007
20000000000000000000000000000000000000000200000000007000777777770777777777770007777777077777777777700077777770777777777777
20000000000000000000000000000000000000000200000000007000000000000000000000070000000000000000000000700000000000000000000007
20000000000000000000000000000000000000000200000000007777777777770777777700077777777777077777777000777777777770777777770007
20000000000000000000000000000000000x00000200000000007000000000000000000000070000000000000000000000700000000000000000000007
20000000000000000000000000000000000000000200000000007000777777777777777777770007777777777777777777700077777777777777777777
20000000000000000000000000000000000000000200000000007000000000000000000000070000000000000000000000700000000000000000000007
20000000000000000000000000000000000000000200000000007777777777777777777700077777777777777777777000777777777777777777770007
20000000000000000000000000000000000000000200000000007000000000000000000000070000000000000000000000700000000000000000000007
20000000000000000000000000000000000000000200000000007000000000000000000000070000000000000000000000700000000000000000000007
20000000000000000000000000000000000000000200000000007777777777777077777777777777777777770777777777777777777777707777777777
20000000000000000000000000000000000000000200000000006666666666666666666666666666666666666666666666666000000000606666666666
20000000000000000000000000000000000000000200000000006666666666666666666666666666666666666666666666666000000080606666666666
20000000000000000000000000000000000000000200000000006000000000000000000000000000000000000000000000000000000090606666666666
20000000000000000000000000000000000000000200000000006666666666666666666666066666666666666666666666666000000000606666666666
20000000000000000000000000000000000000000200000000006666666666666666666666066666666666666666666666666666666666606666666666
20000000000000000000000000000000000000000200000000000000000000000000000006060000000000000000000000600000000000606000000006
20000000000000000000000000000000000000000206666666666666666666666666666606060666666666066666666600606600000666606660000006
20000000000000000000000000000000000000000206444444444444444444444444444606060666666666066666666600606600000600606060000006
20000000000000000000000000000000000000000206466666666666666666666666664606060666666666066666666600606600000666606660000006
20000000000000000000000000000000000000000206464444444444444444444444464606060666666666066666666600606600000600606060000006
20000000000000000000000000000000000000000206464666666666666666666666464606060666666666066666666600606600000666606660000006
20000000000000000000000000000000000000000206464644444444444444444446464606060666666666066666666600606600000600606060000006
20000000000000000000000000000000000000000206464646666666666666666646464606060666666666066666666600606600000666606660000006
22222222222222222200222222222222222222222206464646444444666444444646464606060666666666066666666600606600000600606060000006
22222222222222222200222222222222222222222206464646666666666666666646464606060666666666066666666600606600000666606660000006
22222222222222222200222222222222222222222206464644444444444444444446464606060666666666066666666600606600000600606060000006
22222222222222222200222222222222222222222206464666666666666666666666464606060666666666066666666600606600000666606660000006
22222222222222222200222222222222222222222206464444444444444444444444464606060666666666066666666600606600000600606060000006
22222222222222222200222222222222222222222206466666666666666666666666664606060666666666066666666600606600000666606660000006
22222222222222222200222222222222222222222206444444444444444444444444444606060666666666066666666600606600000600606060000006
22222222222222222200222222222222222222222206666666666666666666666666666606060666666666066666666600606600000666606660000006
22222222222222222200222222222222222222222200000000000000000000000000000006060666666666066666666600606600000600606060000006
11111111111111111100111111111111111111111111111111111111111111111100000006060666666666066666666600606600000666606660000006
10000000000000000000000000000000000000000000000000000000000000000100000006060600000006060000000600606600000600606060000006
10000000000000000000000000000000000000000000000000000000000000000100000006060606666606060666660600606600000666606660000006
10000000000000000000000000000000000000000000000000000000000000000100000006060606600006060000660600606600000600606060000006
10000000000000000000000000000000000000000000000000000000000000000100000006060606666666066666660600606600000666606660000006
10000000000000000000000000000000000000000000000000000000000000000100000006000600000000000000000600606600000600600000000006
10000000000000000000000000000000000000000000000000000000000000000100000006666666666666666666666600606600000666666660000006
10000000000000000000000000000000000000000000000000000000000000000100000000000000000000000000000000606000000000000000000006
10000000000000000000000000000000000000000000000000000000000000000144444444444444444444444444444444404444444444444444444444
10000000000000000000000000000000000000000000000000000000000000000144440000000000000000000000000000000000000000000000000004
10000000000000000000000000000000000000000000000000000000000000000144440000000000000000000000000000000000000000000000000004
10000000000000000000000000000000000000000000000000000000000000000144440000000000000000000000000000000000000000000000000004
10000000000000000000000000000000000000000000000000000000000000000144440000000000000000000000000000000000000000000000000004
10000000000000000000000000000000000000000000000000000000000000000144440000000000000000000000000000000000000000000000000004
10000000000000000000000000000000000000000000000000000000000000000144440000000000000000000000000000000000000000000000000004
10000000000000000000000000000000000000000000000000000000000000000144440000000000000000000000000000000000000000000000000004
10000000000000000000000000000000000000000000000000000000000000000144444444444000000000000000000000000000000000000000000004
10000000000000000000000000000000000000000000000000000000000000000144444444444000000000000000000000000000000000000000000004
10000000000000000000000000000000000000000000000000000000000000000144444444444000000000000000000000000000000000000000000004
10000000000000000000000000000000000000000000000000000000000000000144444444444000000000000000000000000000000000000000000004
10000000000000000000000000000000000000000000000000000000000000000144444444444000000000000000000000000000000000000000000004
10000000000000000000000000000000000000000000000000000000000000000144444444444000000000000000000000000000000000000000000004
10000000000000000000000000000000000000000000000000000000000000000144444444444000000000000000000000000000000000000000000004
10000000000000000000000000000000000000000000000000000000000000000144444444444000000000000000000000000000000000000000000004
10000000000000000000000000000000000000000000000000000000000000000144444444444000000000000000000000000000000000000000000004
10000000000000000000000000000000000000000000000000000000000000000144444444444000000000000000000000000000000000000000000004
10000000000000000000000000000000000000000000000000000000000000000144444444444000000000000000000000000000000000000000000004
10000000000000000000000000000000000000000000000000000000000000000000000000000000000000000000000000000000000000000000000004
10000000000000000000000000000000000000000000000000000000000000000000000000000000000000000000000000000000000000000000000004
10000000000000000000000000000000000000000000000000000000000000000144444444444000000000000000000000000000000000000000000004
11111111111111111111111111111111111111111111111111111111111111111444444444444444444444444444444444444444444444444444444444
