111111111111111111111111111111111111111111
100000000000000000000000000000000000000001
100000000000000000000000000000000000000001
100000000000000000000000000000000000000001
100000000000000000000000000000000000000001
100000000000000000000000000000000000000001
100000000000000000000000000000000000000001
100000000000000000000000000000000000000001
100000000000000000000000000000000000000001
100000000000000000000000000000000000000001
100000000000000000000000000000000000000001
100000000000000000000000000000000000000001
100000000000000000011000000000000000000001
100000000000000000000000000000000000000001
100000000000000000022000000000000000000001
100000000000000000000000000000000000000001
100000000000000000033000000000000000000001
100000000000000000000000000000000000000001
100000000000000000044000000000000000000001
100000000000000000000000000000000000000001
10000000000000000005500000000000000x000001
100000000000000000000000000000000000000001
100000000000000000066000000000000000000001
100000000000000000000000000000000000000001
100000000000000000077000000000000000000001
100000000000000000000000000000000000000001
100000000000000000088000000000000000000001
100000000000000000000000000000000000000001
100000000000000000099000000000000000000001
100000000000000000000000000000000000000001
100000000000000000000000000000000000000001
100000000000000000000000000000000000000001
100000000000000000000000000000000000000001
100000000000000000000000000000000000000001
100000000000000000000000000000000000000001
100000000000000000000000000000000000000001
100000000000000000000000000000000000000001
100000000000000000000000000000000000000001
100000000000000000000000000000000000000001
100000000000000000000000000000000000000001
100000000000000000000000000000000000000001
111111111111111111111111111111111111111111
