111111111111111111111111111111111111111111111111111111111111111111111111111111111
100000000000000000000000000000000000000000000000000000000000000000000000000000001
100000000000000000000000000000000007777777777000000000000000000000000000000000001
100000000000000000000000000000000777700000007770000000000000000000000000000000001
100000000000000000000000000000007770000000000007000000000000000000000000000000001
100000000000000000000000000000007700000000000007700000000000000000000000000000001
100000000000000000000000000000077700000000000070700000000000000000000000000000001
100000000000000000000000000000770770000000000770700000000000000000000000000000001
100000000000000000000000000000770770700000770770770000000000000000000000000000001
100000000000000000000000000000770777770007777770770000000000000000000000000000001
100000000000000000000000000000777777770007777070770000000000000000000000000000001
100000000000000000000000000000077007707770770007000000000000000000000000000000001
100000000000000000000000000000077777077777077077000000000000000000000000000000001
100000000000000000000000000000007770077777077770000000000000000000000000000000001
100000000000000000000000000000000777777777777770000000000000000000000000000000001
100000000000000000000000000000000777777777777770000000000000000000000000000000001
100000000000000000000000000000000077077777707700000000000000000000000000000000001
100000000000000000000000000000000007770000777000000000000000000000000000000000001
100000000000000000000000000000000000077777700000000000000000000000000000000000001
100000000000000000000000000000000000077777770000000000000000000000000000000000001
100000000000000000000000000000000000777777770000000000000000000000000000000000001
100000000000000000000000000000000000077777770000000000000000000000000000000000001
100000000000000000000000000777777777777007777777000000000000000000000000000000001
100000000000000000000077777777777777777777777777777777770000000000000000000000001
100000000000000000077777777777777707777777777777777777777777000000000000000000001
100000000000000000777777777777777777777000777777777777777077700000000000000000001
100000000000000007777070770777077777770007777777070777777777077000000000000000001
100000000000000077077770007707777007770777777077777770007700007000000000000000001
100000000000000770070070077777777777770007777777777777077700007000000000000000001
100000000000000777077777077777777777700000777777777707707777077000000000000000001
100000000000000077777707777077777777700070777777777777777077077000000000000000001
100000000000000077707700707777077777700000077777777777770077077000000000000000001
100000000000000077007007777777777777700000077777777777770077077000000000000000001
100000000000000077007007777777777777700000777777777777707077077000000000000000001
100000000000000077007007777777777777770000777777777777777077077000000000000000001
100000000000000077007007777777777770077077700777777777777077077000000000000000001
100000000000000770007007770000777777777777770777777777777077007000000000000000001
100000000000000770077000777777777077777777777077777707777077007000000000000000001
100000000000000770070007777777770770777077777007777777707077007000000000000000001
100000000000000770070000777007777777770007777770777777777007707000000000000000001
100000000000000770070000777777777777777777770777777777777007707000000000000000001
100000000000000770070000777777770777770777777777777777777007700700000000000000001
100000000000000770070000777707777777777777700777770777770007700700000000000000001
100000000000000770070000777777777700777777700007770777777007700700000000000000001
100000000000000770007000077770770000770007700007777777777007700700000000000000001
100000000000000770007000007770770000777777700007777777700077700770000000000000001
100000000000007707707700000000000007777007770000000000000077000777000000000000001
100000000000007777777700000000000000077777000x00000000000077077007000000000000001
100000000000000777777000007777777000777777700007777770000077777777000000000000001
100000000000007707770000777070007700077077700770007707700007777070000000000000001
100000000000077777700007777700000777777777777770000070070000770707000000000000001
100000000000077777700007707000000077700000777700000000777000770707700000000000001
100000000000770777000007077000000770077777700770000000077000077770700000000000001
100000000000770707000007077000000700770000770770000000770000077770770000000000001
100000000000707770000007777000000777707007707700000007700000077077770000000000001
100000000007707070000000777700007777777707707770000007700000007077070000000000001
100000000077077770000000077700007707707007077070000070000000007007707000000000001
100000000077777770000000000700007700770000077770000770000000000777707000000000001
100000000770770770000000777700000770007007777700007770000000000770777700000000001
100000007777777700000007777707000770777777777000070077777000000770770070000000001
100000007707777000000077000070777777707777777777770777707700000077770077000000001
100000077007770000000077700777707000777777770070777700070700000007770007700000001
100000077707770000000777707770707777777777777770777770070700000007770077700000001
100000077777770000000777007700777007777000777077700770077000000000777777700000001
100007777777700000000077007700007777700000077777000770007000000000777777777000001
100077777777700000000007700700000000000000000000000700077000000000777777777000001
100707077777770000000007770070000000000000000000000700070000000000077077777770001
107777070707770000000007770070000000000000000000007700070000000000077777770777001
177777770707770000000007700070000000000000000000007700700000000000077707770777701
177077770777700000000000777070000000000000000000077007700000000000070707770007001
100007777777000000000000770070000000000000000000077007700000000000077777770000001
100007777777000000000000077007000000000000000000077707000000000000077777770000001
100007777777000000000000077707000000000000000000777077000000000000077777770000001
100007777777000000000000077700700000000000000000770070000000000000077777770000001
100007777770000000000000007700770000000000000000770070000000000000000777770000001
100000777000000000000000007770770000000000000007770770000000000000000077770000001
100000000000000000000000000700070000000000000007770700000000000000000000000000001
100000000000000000000000000770070000000000000007770700000000000000000000000000001
100000000000000000000000000077007000000000000077000700000000000000000000000000001
100000000000000000000000000077007700000000000077000700000000000000000000000000001
100000000000000000000000000077000770000000000777007000000000000000000000000000001
100000000000000000000000000007700770000000000777007000000000000000000000000000001
100000000000000000000000000007700070000000000770007000000000000000000000000000001
100000000000000000000000000007700007000000007700070000000000000000000000000000001
100000000000000000000000000000770007700000077000070000000000000000000000000000001
100000000000000000000000000007777707700000077007077000000000000000000000000000001
100000000000000000000000000007070070770000700777000700000000000000000000000000001
100000000000000000000000000007077077070000700700700700000000000000000000000000001
100000000000000000000000000077007077770000770777707700000000000000000000000000001
100000000000000000000000000000777777700000077777777000000000000000000000000000001
100000000000000000000000000077777777700000777777770000000000000000000000000000001
100000000000000000000000000077770007700000777000770000000000000000000000000000001
100000000000000000000000000070777777700000077707070000000000000000000000000000001
100000000000000000000000000070777777700000077707770000000000000000000000000000001
100000000000000000000000000077770707700000077777770000000000000000000000000000001
100000000000000000000000000077777007700000077007770000000000000000000000000000001
100000000000000000000000000077077007000000077007770000000000000000000000000000001
100000000000000000000000000070777007000000077007770000000000000000000000000000001
100000000000000000000000000070707707000000077070770000000000000000000000000000001
100000000000000000000000000070777707000000077070770000000000000000000000000000001
100000000000000000000000000007777707000000077070770000000000000000000000000000001
100000000000000000000000000007777707000000077070770000000000000000000000000000001
100000000000000000000000000007777707000000070077070000000000000000000000000000001
100000000000000000000000000007777707000000070077770000000000000000000000000000001
100000000000000000000000000000777707000000070777770000000000000000000000000000001
100000000000000000000000000000777707000000070777770000000000000000000000000000001
100000000000000000000000000000777007700000777770770000000000000000000000000000001
100000000000000000000000000000777707700000700770770000000000000000000000000000001
100000000000000000000000000000777777700000700770700000000000000000000000000000001
100000000000000000000000000000070770700000770770700000000000000000000000000000001
100000000000000000000000000000077770070000770707700000000000000000000000000000001
100000000000000000000000000000007000070000770707000000000000000000000000000000001
100000000000000000000000000000007000007007700777000000000000000000000000000000001
100000000000000000000000000000007777077007700777000000000000000000000000000000001
100000000000000000000000000000007777770007777777000000000000000000000000000000001
100000000000000000000000000000007777777007777777000000000000000000000000000000001
100000000000000000000000000000007777707007700770000000000000000000000000000000001
100000000000000000000000000000007077770007077007000000000000000000000000000000001
100000000000000000000000000000777777777007077000777000000000000000000000000000001
100000000000000000000000000077777770707077077777777700000000000000000000000000001
100000000000000000000000000077770770777007777777777700000000000000000000000000001
100000000000000000000000000007700700077000770777777000000000000000000000000000001
100000000000000000000000000000000000000000000000000000000000000000000000000000001
100000000000000000000000000000000000000000000000000000000000000000000000000000001
111111111111111111111111111111111111111111111111111111111111111111111111111111111
