11111111111111111111111111111111111111111111111111111111111111111111111111111111111
10000000000000000000000000000000000000000000000000000000000000000000000000000000001
1000000000007000000000000000000000000000x000000000000000000000000007000000000000001
10000000007700000000000000000007000000000000000007000000000000000000770000000000001
10007000777000000000000000000770000000000000000000770000000000000000077700007000001
10070000777000000000700000007700000000000000000000077000000070000000077700000700001
10777000077700000077770000770000000000000000000000000770000777700000777000007770001
10777777000000077777777077777777000000000000000007777777707777777700000007777770001
10077777777777777777777777777777777000000000007777777777777777777777777777777700001
10007777777777777777777777777000077777700077777700007777777777777777777777777000001
10000077777777777777707777700090000007770777000000900077777077777777777777700000001
10000000007777777000000077700000000007770777000000000077700000007777777000000000001
10000000000000000000000000777000777777770777777770007777000000000000000000000000001
10000000000000000000000077777777777777000007777777777777700000000000000000000000001
10000000000000000000000777777777777770000000777777777777770000000000000000000000001
10000000000000000000007777777777777700070700077777777777777000000000000000000000001
10000000000000000000007777700077777777770777777777700077777000000000000000000000001
10000000000000000000000770000007777777700077777777000000770000000000000000000000001
10000000000000000000000700000000777707770777077770000000700000000000000000000000001
10000000000000000000000000000000777777700077777770000000000000000000000000000000001
10000000000000000000000000000000770700700070070770000000000000000000000000000000001
10000000000000000000000000000000070070000000700700000000000000000000000000000000001
10000000000000000000000000000000070000000000000700000000000000000000000000000000001
10000000000000000000000000000000000000000000000000000000000000000000000000000000001
11111111111111111111111111111111111111111111111111111111111111111111111111111111111
